# Syntax Coloring Map
# Datatypes (KEYWORD1)

# Methods and Functions (KEYWORD2)
ircSetClient	KEYWORD2
ircSetServer	KEYWORD2
ircConnect	KEYWORD2
ircSetNick	KEYWORD2
ircNick	KEYWORD2
ircSetVersion	KEYWORD2
ircSetServerPassword	KEYWORD2
ircSetNickServPassword	KEYWORD2
doIRC	KEYWORD2
ircJoinChannel	KEYWORD2
ircSendMessage	KEYWORD2
ircSendNotice	KEYWORD2
ircSendCTCP	KEYWORD2
ircSendAction	KEYWORD2
ircAway	KEYWORD2
ircUnAway	KEYWORD2
ircConnected	KEYWORD2
ircMode	KEYWORD2
ircDisconnect	KEYWORD2
ircSetOnConnect	KEYWORD2
ircOnConnect	KEYWORD2
ircSetOnDisconnect	KEYWORD2
ircOnDisconnect	KEYWORD2
ircSetOnPrivateMessage	KEYWORD2
ircOnPrivateMessage	KEYWORD2
ircSetOnAction	KEYWORD2
ircSetOnCTCP	KEYWORD2
ircOnCTCP	KEYWORD2
ircSetOnChannelMessage	KEYWORD2
ircOnChannelMessage	KEYWORD2
ircSetOnPrivateNotice	KEYWORD2
ircOnPrivateNotice	KEYWORD2
ircSetOnChannelNotice	KEYWORD2
ircOnChannelNotice	KEYWORD2
ircSetOnVoice	KEYWORD2
ircOnVoice	KEYWORD2
ircSetOnOp	KEYWORD2
ircOnOp	KEYWORD2
ircSetOnNickChange	KEYWORD2
ircOnNickChange	KEYWORD2
ircSetOnRaw	KEYWORD2
ircOnRaw	KEYWORD2
ircSetNetworkLightOn	KEYWORD2
ircNetworkLight	KEYWORD2
ircSetDebug	KEYWORD2
ircDebug	KEYWORD2

# Instances (KEYWORD2)

# Constants (LITERAL1)
IRC_COLOURS_NORMAL	LITERAL1
IRC_COLOURS_BOLD	LITERAL1
IRC_COLOURS_UNDERLINE	LITERAL1
IRC_COLOURS_REVERSE	LITERAL1
IRC_COLOURS_WHITE	LITERAL1
IRC_COLOURS_BLACK	LITERAL1
IRC_COLOURS_BLUE	LITERAL1
IRC_COLOURS_GREEN	LITERAL1
IRC_COLOURS_RED	LITERAL1
IRC_COLOURS_BROWN	LITERAL1
IRC_COLOURS_MAGENTA	LITERAL1
IRC_COLOURS_ORANGE	LITERAL1
IRC_COLOURS_YELLOW	LITERAL1
IRC_COLOURS_LIGHT_GREEN	LITERAL1
IRC_COLOURS_TEAL	LITERAL1
IRC_COLOURS_CYAN	LITERAL1
IRC_COLOURS_LIGHT_BLUE	LITERAL1
IRC_COLOURS_PINK	LITERAL1
IRC_COLOURS_GREY	LITERAL1
IRC_COLOURS_LIGHT_GREY	LITERAL1
IRC_COLOURS_DEFAULT	LITERAL1
IRC_COLORS_NORMAL	LITERAL1
IRC_COLORS_BOLD	LITERAL1
IRC_COLORS_UNDERLINE	LITERAL1
IRC_COLORS_REVERSE	LITERAL1
IRC_COLORS_WHITE	LITERAL1
IRC_COLORS_BLACK	LITERAL1
IRC_COLORS_BLUE	LITERAL1
IRC_COLORS_GREEN	LITERAL1
IRC_COLORS_RED	LITERAL1
IRC_COLORS_BROWN	LITERAL1
IRC_COLORS_MAGENTA	LITERAL1
IRC_COLORS_ORANGE	LITERAL1
IRC_COLORS_YELLOW	LITERAL1
IRC_COLORS_LIGHT_GREEN	LITERAL1
IRC_COLORS_TEAL	LITERAL1
IRC_COLORS_CYAN	LITERAL1
IRC_COLORS_LIGHT_BLUE	LITERAL1
IRC_COLORS_PINK	LITERAL1
IRC_COLORS_GRAY	LITERAL1
IRC_COLORS_LIGHT_GRAY	LITERAL1
IRC_COLORS_DEFAULT	LITERAL1
